11111111111111111111
10020000000000000001
11111111111001111111
11100000000000000111
11111111110000000001
10000000000000000001
10000111111111111111
11100000000000000001
10000111111000011111
10000000000000000001
11111000000000000001
10000000000000000001
10000011111111000001
10000000011100001111
10000000000000000001
11111111111100000001
10000000000000000001
10000111111111111111
10000000000000003001
11111111111111111111